5 16
|--------------|
|F..|..-.......|
|..-|.@........|
|F.....-.......|
|--------------|